Findlater: Findlater Stewart, 
Robert: Robert Brook, 
Dick: Dick Butler, Dick White, Dick Ellis, 
Van: Van Moyland, Van Oorschott, 
Guy: Guy BURGESS, Guy Fawkes, 
Royal: Royal Prerogative, 
Leighton: Leighton St, 
Bill: Bill Magan, Bill Stephenson, 
Noel: Noel Wild, 
John: John Maffey, John Maude, John Shaw, John Marriott, John Charles, John Anderson, 
Tommy: Tommy HARRIS, Tommy Harris, 
Queen: Queen Mary, 
Kim: Kim Philby, 
Peter: Peter Dwyer, Peter Hope, 
Herschel: Herschel Johnson, 
Lish: Lish Whitson, 
Alec: Alec Kellar, 
Max: Max Knight, 
Walter: Walter Bell, Walter THOMAS, 
Norman: Norman Brook, 
Cuthbert: Cuthbert Fleetwood, 
Anthony: Anthony Blunt, 
Dorothy: Dorothy WOODMAN, 
Desmond: Desmond Morton, 
George: George Jenkin, 
Gerald: Gerald Templer, 
Duke: Duke Robert, 
Henry: Henry Tizard, 
Harry: Harry Allen, 
Paul: Paul FIDRMUC, 
Joe: Joe Stephenson, Joe Spencer, Joe Archer, 
San: San Francisco, 
Courtenay: Courtenay Young, 
Roger: Roger Fleetwood, Roger Hollis, Roger Moore, 
Ronnie: Ronnie Howe, 
Marshal: Marshal Wilson, 
Geoffrey: Geoffrey Patterson, 
James: James Robertson, 
Thomas: Thomas Lloyd, 
Malayan: Malayan Union, 
Frank: Frank Newsam, 
Jane: Jane Archer, 
Jim: Jim Hale, 
Charles: Charles Peake, Charles Butler, 
Jack: Jack Easton, Jack Morton, 
Attorney: Attorney Generat, 
Oxford: Oxford Don, 
Michael: Michael Serpell, 
Ned: Ned Reid, 
Kenneth: Kenneth Strong, 
Jo: Jo Archer, 
Admiral: Admiral Thomson, 
Douglas: Douglas Roberts, 
Graham: Graham Mitchell, 
Alexander: Alexander Maxwell, 
Duff: Duff Cooper, 